NO maps/textures/WOOD_1C.PNG
EA maps/textures/BRICK_3B.PNG
SO maps/textures/BRICK_3D.PNG
WE maps/textures/HEDGE_1A.PNG

D1 maps/textures/DOOR_1A.PNG
D2 maps/textures/DOOR_1C.PNG
D3 maps/textures/DOOR_1E.PNG

F 220,100,0
C 225,30,0

1111111
1002001
1121211
1E02001
1111111