NO maps/textures/BRICK_1A.PNG
SO maps/textures/BRICK_1A.PNG
EA maps/textures/BRICK_1A.PNG
WE maps/textures/BRICK_1A.PNG

D1 maps/door.png
D2 maps/door_opening.png

F 220,100,0
C 225,30,0

        1111111111111111111111111
        1000000000110000000000001
        1011000001110000000000001
        1001000000200000000000001
111111111211000001110000000000001
100000000011000001112111111111111
11110111111111011100000010001
11112111111111211101010010001
11000000110101011100000010001
10000000000000001100000010001
10000000000000001101010000001
11000001110101011111011110N0111
11110111 1110101 101111010001
11111111 1111111 111111111111
