NO maps/textures/BRICK_1A.PNG
SO maps/textures/BRICK_1A.PNG
EA maps/textures/BRICK_1A.PNG
WE maps/textures/BRICK_1A.PNG
F 220,100,0
C 225,30,0

11111111111111111
10000000000000001
10000000000000001
11101111111111011
10000000000000001
10000000000000001
10000000000000001
11111101100110011
10000000000000001
11111111111111111
