
F            255,255,160
C 61,65,61

NO maps/textures/PAPER_1B.PNG

EA       maps/textures/PAPER_1B.PNG

SO maps/textures/PAPER_1B.PNG

WE maps/textures/PAPER_1F.PNG

1111111111111111111111111111111111111111111111111111111111111111111111111111111111111
1000001000001000001000001000001000001000001000001000001000001000001000001000001000001
1000001000001000001000001000001000001000001000001000001000001000001000001000001000001
1000000000000000000000000000000000000000000000000000000000000000000000000000000000001
1000001000001000001000001000001000001000001000001000001000001000001000001000001000001
1000001000001000001000001000001000001000001000001000001000001000001000001000001000001
1110111110111110111110111110111110111110111110111110111110111110111110111110111110111
1000001000001000001000001000001000001000001000001000001000001000001000001000001000001
1000001000001000001000001000001000001000001000001000001000001000001000001000001000001
1000000000000000000000000000000000000000000000000000000000000000000000000000000000001
1000001000001000001000001000001000001000001000001000001000001000001000001000001000001
1000001000001000001000001000001000001000001000001000001000001000001000001000001000001
1110111110111110111110111110111110111110111110111110111110111110111110111110111110111
1000001000001000001000001000001000001000001000001000001000001000001000001000001000001
1000001000001000001000001000001000001000001000001000001000001000001000001000001000001
1000000000000000000000000000000000000000000000000000000000000000000000000000000000001
1000001000001000001000001000001000001000001000001000001000001000001000001000001000001
1000001000001000001000001000001000001000001000001000001000001000001000001000001000001
1110111110111110111110111110111110111110111110111110111110111110111110111110111110111
1000001000001000001000001000001000001000001000001000001000001000001000001000001000001
1000001000001000001000001000001000001000001000001000001000001000001000001000001000001
1000000000000000000000000000000000000000000000000000000000000000000000000000000000001
1000001000001000001000001000001000001000001000001000001000001000001000001000001000001
1000001000001000001000001000001000001000001000001000001000001000001000001000001000001
1110111110111110111110111110111110111110111110111110111110111110111110111110111110111
1000001000001000001000001000001000001000001000001000001000001000001000001000001000001
1000001000001000001000001000001000001000001000001000001000001000001000001000001000001
100000000000000000000000000000000000000S000000000000000000000000000000000000000000001
1000001000001000001000001000001000001000001000001000001000001000001000001000001000001
1000001000001000001000001000001000001000001000001000001000001000001000001000001000001
1110111110111110111110111110111110111110111110111110111110111110111110111110111110111
1000001000001000001000001000001000001000001000001000001000001000001000001000001000001
1000001000001000001000001000001000001000001000001000001000001000001000001000001000001
1000000000000000000000000000000000000000000000000000000000000000000000000000000000001
1000001000001000001000001000001000001000001000001000001000001000001000001000001000001
1000001000001000001000001000001000001000001000001000001000001000001000001000001000001
1110111110111110111110111110111110111110111110111110111110111110111110111110111110111
1000001000001000001000001000001000001000001000001000001000001000001000001000001000001
1000001000001000001000001000001000001000001000001000001000001000001000001000001000001
1000000000000000000000000000000000000000000000000000000000000000000000000000000000001
1000001000001000001000001000001000001000001000001000001000001000001000001000001000001
1000001000001000001000001000001000001000001000001000001000001000001000001000001000001
1110111110111110111110111110111110111110111110111110111110111110111110111110111110111
1000001000001000001000001000001000001000001000001000001000001000001000001000001000001
1000001000001000001000001000001000001000001000001000001000001000001000001000001000001
1000000000000000000000000000000000000000000000000000000000000000000000000000000000001
1000001000001000001000001000001000001000001000001000001000001000001000001000001000001
1000001000001000001000001000001000001000001000001000001000001000001000001000001000001
1110111110111110111110111110111110111110111110111110111110111110111110111110111110111
1000001000001000001000001000001000001000001000001000001000001000001000001000001000001
1000001000001000001000001000001000001000001000001000001000001000001000001000001000001
1000000000000000000000000000000000000000000000000000000000000000000000000000000000001
1000001000001000001000001000001000001000001000001000001000001000001000001000001000001
1000001000001000001000001000001000001000001000001000001000001000001000001000001000001
1111111111111111111111111111111111111111111111111111111111111111111111111111111111111
