NO textures/wolfenstein/grey_stone.xpm
SO textures/wolfenstein/purple_stone.xpm
WE textures/wolfenstein/red_brick.xpm
EA textures/wolfenstein/wood.xpm

F 220,100,0
C 225,30,0


1011111111111111111
1010000000000000001
1010000000000000001
1011101111111111011
1010000000000000001
101000000000S000001
1010000000000000001
1011111101100110011
1010000000000000001
1111111111111111111
