NO maps/textures/TECH_1E.PNG
EA maps/textures/TECH_2F.PNG
SO maps/textures/TECH_3B.PNG
WE maps/textures/TECH_4F.PNG

F 73,56,61
C 91,101,103
1111111
1000001
110S011
1000001
1110111
1110111
1110111
1110111111111111111
1000000000000000001
1000000000000000001
1000000000000000001
1000000000000000001
1000000000000000001
1111111111111111111


